--------------------
N-Queens Solution for N=8:
Q . . . . . . . 
. . . . . . Q . 
. . . . Q . . . 
. . . . . . . Q 
. Q . . . . . . 
. . . Q . . . . 
. . . . . Q . . 
. . Q . . . . . 
--------------------
